// map rows  <=2 error

NO ./textures/wall_n.xpm
SO ./textures/wall_s.xpm
WE ./textures/wall_w.xpm
EA ./textures/wall_e.xpm
S ./textures/sprite.xpm

R   500   500

F 50,    50,    50 
C 0, 150,   200
        1111111111111111111111111
11111111 1111111 111111111111
