NO ./textures/wall_n.xpm
SO ./textures/wall_s.xpm
WE ./textures/wall_w.xpm
EA ./textures/wall_e.xpm
S ./textures/sprite.xpm

R   500   500

F 50,    50,    50 
C 0, 150,   200
        1111111111111111111111111
        1000000000110000000000001
        1011000001110000000000201
        1001000000000000000000001
111111111011000001110000000000001
100000000011000001110111111111111
11110111111111011100000010001
1111011111111101110101000020111
1100000011010101110000001000001
1000200000000000000000001000111
10000000000000001101010010001
11000001110101011111011110N0111
11110111 1110101 101111010001
11111111 1111111 111111111111
